5 7 143 3133 1624 1739 2077 3316 4788 
5 8 4788 3257 4815 4833 4099 4865 3262 4895 
5 8 4895 358 3649 3957 4887 787 4891 4883 
5 8 4883 4875 431 3878 4888 4144 2679 4896 
5 19 4896 813 4085 4932 4964 4944 1277 1458 1181 426 4995 3959 2119 2023 4293 3319 3464 5120 2317 
5 7 5120 5140 2325 4014 4076 3767 3078 
5 2 3078 3076 
5 13 4544 4557 300 4577 3164 1997 1129 4641 4200 4669 4697 200 143 
3 11 4895 1812 2874 3572 1591 1474 4816 1669 2470 4793 1914 
3 3 3816 6537 1914 
3 11 200 1982 4694 3825 2724 2526 1296 4654 2135 4633 527 
5 6 5061 2997 4319 853 377 4944 
5 9 5140 1588 2261 2706 1946 5088 1308 2826 5061 
5 14 5061 1271 2776 3535 3864 5142 5157 2372 5191 3172 5231 2897 4258 3076 
5 8 2013 2164 916 739 2066 3837 5132 2317 
5 11 4895 212 4931 4943 3529 3941 774 4165 2122 3527 2013 
1 18 4544 3855 727 4519 4271 4525 4212 4543 1200 2716 145 3450 3120 4625 4639 4649 3845 4654 
5 5 143 4713 1263 4687 4686 
5 6 4686 3955 2310 4073 2856 4681 
5 4 4063 231 4615 4620 
1 3 6479 4586 4063 
5 8 4557 1060 1039 4555 3591 913 1378 215 
5 5 215 4207 4580 4591 4063 
5 4 4896 2016 4911 4919 
5 5 4919 1938 4197 1715 1020 
5 8 1020 1047 4889 1105 4849 2669 4817 4803 
5 4 4803 1067 1488 4755 
5 5 4755 4436 3749 4708 4701 
5 5 4701 2976 4677 3565 873 
5 5 4681 2582 3800 715 873 
5 3 873 4637 4620 
1 3 4553 215 4590 
1 7 3036 4854 3290 137 4935 4953 559 
1 4 4854 3327 2602 6592 
1 4 6592 2111 3906 3816 
1 6 6586 6588 2729 1513 4766 2111 
1 4 6586 2089 4710 2900 
3 6 6601 6600 1107 4671 3823 4693 
3 6 4693 1797 4729 1741 6536 3816 
3 7 4693 6589 4675 6560 4059 4632 527 
1 11 2013 4070 946 115 5081 91 613 2361 5007 2341 559 
1 3 4809 4825 3036 
1 6 4809 2012 815 1868 6552 6586 
1 4 2224 7 795 3227 
1 6 3227 2154 3272 1468 4977 559 
1 2 3531 5410 
1 9 5410 532 2607 3478 840 5417 3580 2270 5423 
1 8 53 5261 4153 719 5344 1148 2083 5410 
1 6 4153 3918 5284 3088 1777 5245 
1 4 53 3027 5183 5154 
1 5 2564 2439 2544 566 53 
1 5 2564 5161 3943 218 5076 
1 3 5076 2533 2224 
1 8 5134 732 5135 5127 1505 3883 5102 2182 
1 4 2182 2838 868 5076 
1 5 2182 1509 2128 2197 3573 
1 4 3573 2121 3560 1977 
1 7 1977 1475 2646 4884 121 4829 4809 
1 7 5134 2528 5114 2445 5093 5087 3672 
1 4 3672 1569 1836 5003 
1 3 5003 4990 4166 
1 3 4166 4981 2550 
1 8 848 1883 1110 4858 2731 388 4781 3021 
1 4 2064 4853 3684 1883 
1 2 342 388 
1 3 4776 1963 342 
1 4 2064 4822 1384 4776 
1 5 4776 3484 3942 1046 3021 
1 4 388 3601 3643 1977 
1 4 6601 4618 2095 4587 
1 4 4632 1465 2294 4631 
1 4 4631 6571 2025 4587 
1 4 4549 1940 4573 4592 
1 2 758 4549 
1 5 758 4507 4497 1340 4479 
1 6 2430 785 1179 4455 1631 3625 
1 5 4479 3966 3266 4457 3625 
1 6 4587 3356 1385 1012 1929 4549 
1 6 3625 4462 4145 2080 1678 4490 
1 6 4490 310 332 1010 3125 758 
1 3 4592 2210 527 
1 3 2317 552 5201 
1 14 3478 164 3128 1667 2272 4199 43 980 3183 5638 5654 4160 1618 5716 
1 6 5714 990 883 1487 2101 5716 
1 4 5716 184 2884 2662 
1 6 2662 5780 684 646 775 5791 
1 11 5201 2269 384 3145 1056 3387 3872 2715 5415 1566 4040 
1 5 4040 5459 4176 5460 2370 
1 7 2370 4081 1888 884 733 5435 3207 
1 7 3207 5440 4259 3607 1570 3052 5424 
1 5 5467 2815 5478 94 5496 
1 4 5424 2222 3516 5467 
1 6 5496 3502 5461 5444 3930 3035 
1 3 5467 620 3930 
1 4 3417 1312 5394 3035 
1 8 117 2100 4154 547 2663 3557 4155 5502 
1 5 2370 3201 4101 1204 3011 
1 9 3011 2793 5573 669 5561 2155 3006 2483 5550 
1 3 5550 5553 5562 
1 4 5550 2293 5521 4158 
1 6 4158 4379 5482 6570 2508 5467 
1 4 5562 4370 1211 117 
1 4 5632 1712 196 5705 
1 3 2572 3922 5705 
1 5 5805 2276 5786 350 2572 
1 5 5719 1192 818 2214 5705 
1 6 2256 5792 1702 5737 2186 5719 
1 6 2256 3892 3347 325 5800 5805 
1 5 117 3277 5612 1416 5632 
1 4 3004 1971 4130 1076 
1 3 1076 3563 2256 
1 11 3535 3868 5077 2739 457 5044 3331 4996 4974 4113 1728 
1 3 1728 3550 4909 
1 4 1047 73 2418 4909 
1 6 5423 1657 2755 2935 1772 3872 
1 5 2572 824 2242 3681 1547 
1 4 917 5883 5806 1547 
1 5 2219 444 3493 324 1205 
1 5 5983 2381 1935 470 1205 
1 3 1205 5896 3499 
1 5 5851 1485 3671 4033 1205 
1 4 5851 1235 5818 3653 
1 8 3653 4000 1381 5768 119 2185 2940 4305 
1 4 67 3388 236 2185 
1 4 5594 5615 1044 67 
1 8 5502 1989 1699 1151 5588 4149 1535 5615 
1 4 1712 3414 3112 5588 
1 4 1547 2138 3321 119 
1 7 917 3408 5847 3993 1687 2523 2219 
1 7 2219 4174 2808 2631 116 3215 6080 
1 3 2021 1617 6080 
1 2 2021 6623 
1 4 6623 854 6172 1359 
1 6 1438 3437 6220 2928 131 1359 
1 4 1438 488 1910 6311 
1 4 6311 6293 6317 6315 
1 3 6315 6352 171 
1 4 6315 365 3056 1438 
1 5 171 6378 168 286 6428 
1 3 2448 1635 6428 
1 5 6428 2028 3820 6438 2283 
1 6 2448 768 1388 6455 6446 2283 
1 6 2283 1319 6441 6447 6435 6434 
1 5 6390 1622 6420 1333 6434 
1 4 6390 1278 3992 2911 
1 4 6434 1955 3068 2911 
1 6 6334 3212 4115 3508 6367 2911 
1 5 6390 6380 6359 935 6334 
1 5 1568 30 3820 6438 2283 
1 4 171 797 1965 1568 
1 5 6311 2975 6316 3235 6334 
1 6 1568 3540 1470 6359 935 6334 
1 5 171 2919 1001 1499 6311 
1 7 1359 3426 2431 3362 2587 3235 6334 
1 11 2911 6351 6325 3640 1091 6274 2321 169 2509 6208 1359 
1 7 6366 6353 1364 2641 3574 225 3680 
1 3 3680 2002 1393 
1 5 3283 6187 1574 2966 1393 
1 3 6590 2592 3283 
1 4 3283 792 6137 1620 
1 5 3482 1804 6296 1167 3680 
1 5 5791 3176 5760 2426 2035 
1 4 669 2621 779 954 
1 7 954 5689 345 678 5708 1589 5740 
1 9 5740 2722 2129 1862 3599 5832 1400 1367 2035 
1 5 2711 18 4415 5889 59 
1 7 5931 3010 5849 5862 2992 5846 2711 
1 4 2711 4301 1424 5791 
1 4 465 1583 5957 3824 
1 3 465 3477 2725 
1 5 5966 1818 5938 1834 3824 
1 3 5966 5889 59 
1 3 59 295 1367 
1 2 3599 1811 
1 5 1811 402 5899 3456 3824 
1 6 3394 2695 512 19 5974 1069 
1 3 19 6016 2848 
1 6 2848 6035 2144 3598 1967 6080 
1 8 3892 3946 5850 1081 861 5900 5920 1069 
1 6 5956 708 5935 593 856 3004 
1 5 1620 6085 6070 2556 4430 
1 7 5956 2074 2323 4430 2556 4402 3394 
1 6 6590 6597 2945 2070 2618 1438 
1 5 6366 4335 1214 6372 171 
1 3 3783 4194 3482 
1 5 6370 478 4247 2075 3783 
1 4 3893 1391 1048 6370 
1 4 6386 3213 1813 3893 
1 3 4388 4418 3893 
1 3 6266 3194 4388 
1 3 3989 6242 6266 
1 5 3011 4168 3256 2599 412 
1 7 412 4128 2468 3264 1149 5459 4040 
1 4 3989 975 4416 432 
1 4 2900 3603 1925 6601 
1 3 2590 707 4689 
1 3 4689 3344 3561 
1 5 3561 4733 2650 3729 4776 
1 4 3963 4584 4214 2024 
1 4 2024 830 1886 3662 
1 4 4643 3687 830 2024 
1 4 4643 748 4651 2590 
1 4 4594 1543 4558 574 
1 3 3018 2987 574 
1 6 4643 4621 2386 4601 3780 574 
1 6 3018 4012 4556 1143 2115 3963 
1 5 1698 4493 4509 4521 3018 
1 4 4214 132 524 3222 
1 6 4813 3444 3637 4754 1295 4716 
1 5 1482 2457 3396 5072 2674 
1 7 1482 3042 2953 177 330 2833 4084 
1 5 4084 2415 106 3618 5158 
1 5 5060 5073 1849 645 5158 
1 4 5158 2227 2539 158 
1 4 158 3791 750 2044 
1 4 2044 3062 5369 5362 
1 5 2044 772 5287 1009 5291 
1 4 5362 3241 5334 1870 
1 5 5334 4061 5315 638 1429 
1 6 5362 5377 190 2104 5399 2177 
1 4 2177 4325 5468 5489 
1 4 2177 2709 408 5426 
1 3 5555 2117 5565 
1 3 5565 624 5596 
1 4 5565 5541 5507 159 
1 6 5596 3510 3345 1766 4310 2079 
1 4 159 5522 2865 1542 
1 5 5596 1035 2885 1492 2471 
1 4 5382 3425 2926 1542 
1 5 5382 253 4071 1257 5291 
1 5 1542 3376 5437 584 1652 
1 4 5362 2978 3789 1652 
1 4 1652 1272 239 355 
1 5 2471 5569 34 1236 5503 
1 3 5503 5493 584 
1 3 355 4316 100 
1 4 5489 2558 892 100 
1 3 100 2474 5570 
1 5 3923 3517 375 2850 5570 
1 4 3923 5523 5531 5546 
1 5 327 516 3852 6527 5546 
1 5 4433 3696 2271 2073 2851 
1 3 2851 5730 1755 
1 4 3554 554 5685 4307 
1 5 4307 1171 5725 1912 3688 
1 7 3688 97 1242 2507 5823 4215 2510 
1 4 2961 1792 85 309 
1 4 1755 2134 1912 3688 
1 4 2079 871 263 2851 
1 6 463 534 5579 2603 5564 355 
1 4 2471 1627 5577 463 
1 4 2603 3752 1008 3554 
1 6 4594 1722 3985 2102 4617 6483 
1 7 4689 4672 1856 3646 2102 4617 6483 
1 4 6483 4611 2029 1066 
1 12 4501 338 4021 4146 4585 3677 4613 2096 4630 4650 4640 1066 
1 5 2314 442 972 3144 4501 
1 4 2246 4477 4472 2314 
1 5 2567 4458 4469 1780 2314 
1 5 1603 4460 2307 4456 2567 
1 5 1603 3280 4481 1544 4501 
1 3 6611 5318 5317 
1 7 3263 5378 4054 5363 5328 5308 2087 
1 3 2263 3191 2087 
1 4 2263 3210 926 5317 
1 4 5134 732 1945 1928 
1 4 5226 3180 5215 1928 
1 4 5226 5235 5260 2263 
1 3 3263 3896 3017 
1 2 3017 5420 
1 3 5420 118 5463 
1 4 5463 5472 5499 1023 
1 4 1023 6487 2465 327 
1 4 3554 4323 5636 2091 
1 7 2091 5624 450 5605 3782 1536 2427 
1 4 2427 1494 3797 5641 
1 3 3852 1382 2721 
1 4 2721 1275 4121 5670 
1 4 5641 3665 1798 5670 
1 3 3348 3501 3082 
1 3 741 6014 3348 
1 12 1683 6164 445 4053 1089 3522 722 140 6024 3576 6026 3348 
1 4 2744 5954 1137 5962 
1 4 2744 5954 2584 5993 
1 6 617 2133 3545 6005 6015 5993 
1 5 696 2792 6064 4360 617 
1 4 696 2178 3525 6153 
1 5 2018 1387 6034 1950 696 
1 3 5947 977 2018 
1 5 5947 3748 5910 433 3020 
1 5 5947 4163 563 363 2744 
1 4 3020 5856 1628 354 
1 5 3720 5870 5895 1432 2744 
1 6 2245 2466 5711 2489 4249 5714 
1 2 5653 3060 
1 4 5653 6610 5611 5591 
1 3 5591 4105 327 
1 4 6153 6167 386 716 
1 10 716 3322 2216 6110 6143 6130 6144 1584 6164 1683 
1 6 6229 2354 3776 3084 386 716 
1 4 2437 343 6305 6312 
1 5 2437 1019 2429 1947 716 
1 5 6229 1525 1085 6305 6312 
1 6 6312 3265 1832 2247 4034 3716 
1 5 2623 6244 3301 6267 3716 
1 3 3352 4394 2623 
1 6 3352 4190 1463 500 385 2982 
1 5 3352 4190 2316 1071 2915 
1 5 2915 6354 3733 385 2982 
1 3 2982 731 2376 
1 6 1252 4404 349 745 6398 6396 
1 3 1953 3682 6396 
1 3 1186 2832 1953 
1 2 1255 1186 
1 2 1953 3307 
1 4 1729 4193 3542 3307 
1 5 69 5866 3841 671 354 
1 3 3988 5866 69 
1 4 69 5882 1966 3109 
1 7 69 4036 5908 2375 1582 5964 2018 
1 5 5799 2878 4175 127 3988 
1 4 5799 937 76 3109 
1 6 5799 1467 3998 3518 4007 3051 
1 5 354 4294 2017 5766 3051 
1 11 3720 1028 2659 5796 1292 1852 5779 306 5776 5766 3051 
1 3 2245 5724 1852 
1 4 3051 5676 3984 3060 
1 4 3600 479 1162 3051 
1 6 2961 1460 828 5825 5814 5799 
1 5 309 4177 5785 395 5799 
1 5 3688 1349 2458 2327 2961 
1 3 5670 5672 3600 
1 3 3060 5675 1767 
1 3 1767 1690 2245 
1 3 2172 3424 2564 
1 5 4075 3728 449 5242 2172 
1 4 4075 13 5313 1496 
1 4 1496 2504 984 2478 
1 5 6611 2991 5292 1356 4075 
1 3 6611 5325 5329 
1 4 2087 3908 3369 2671 
1 2 6539 5414 
1 3 5414 5393 2671 
1 4 6539 2051 1866 6484 
1 3 6484 5494 2465 
1 4 926 2639 191 3760 
1 4 3760 5228 5204 2237 
1 5 5135 5141 1141 5174 2237 
1 4 2237 3156 3309 2093 
1 5 2093 4315 5115 868 5076 
1 5 5226 2872 2114 5166 1351 
1 5 3421 3131 5221 2922 3368 
1 5 3421 5176 3770 4334 1351 
1 6 1351 1159 1051 648 732 5134 
1 4 5316 513 607 3368 
1 2 2820 3421 
1 4 2820 5148 3551 2605 
1 7 2820 5197 628 2643 607 513 5316 
1 3 2605 1557 2910 
1 9 432 6163 6146 2255 670 6060 1324 6014 3348 
1 9 741 5988 258 568 5970 685 3090 1428 5966 
1 2 2550 848 
1 5 1429 2312 5341 3134 408 
1 4 1429 5331 176 5316 
1 5 5426 5466 5479 687 3923 
1 7 5426 3840 3612 2324 5433 5419 3017 
1 5 158 5268 4235 5301 1870 
1 5 5158 520 680 4141 4074 
1 8 4074 5188 3970 1453 5255 3521 210 1870 
1 2 2376 1252 
1 3 3082 3092 5931 
